00000000000000000000
00000000000000000010
00000000000000000000
00001000011111100000
00001000000000000000
10001000000000001000
00000000000000000000
00000000000000000000
00000000000000000000
00010000000000010001
00000000000000010000
00000111111000010000
00000000000000000000
01000000000000000000
00000000000000000000
